▒▒▓▓▓▓█▒▓▓█▒▒░ ░▓▓█▓▓▒▓▓██▓▓▓▒░ ░▒▓▓█▒░█▓▓▓▒ ▒▒▓▓███▓▓ ▒▓▓█░ ░▒█▓█▓▓▓██░ █▓█▓▓███ ░▒▒▒▓▓█░▒▒▒▓▓██▓▓▓
░▓▓▒▓█▒▒▒▓▓█▒▒▒▒▒█▓▓▓ ███▓▓▒▒▒░░░▒▒▓▓█ ███▒▒░▒▓▓█▒█▓▓▓▒▓▓███░██▓▓▒▒▒▓▓▓██▓▓▓▓▓▓█▓░░▒▒▓▓▓█░░▒▒▓▓▓█▓▒▓
░░▒▒██▓▒▒▒▓▓█▒▒▒▓▓██▓█▓███▓▓▒▒▒▒▒▒▓▓▓██▓███▒▓▒▒▓█▒░█▓▓▓▓███▓█▓█▓▓▒▒▓▒█▓▓██▒▒▒▓█▓▓▓▒▒▓▓██░ ░░▒▓▓█ ░▒▒
 ░░▒▓▓█ ▒▒▒▓█▓▒█▓▓███▓▓▓██▓▓▓▒▒▓▒▒▓▓█▓▓▓▓█▓█▓▒▓▓▓█ ░█▓▓██▓█▓▓▓██▒▒░▒▒▒▓▓█▓ ▒▓▓▓█▓▓▒▓▓█▓▒▒▒░▒▒▓█▒░██▓
░▒▒▓▓█▓█▒▒▓▓█▓▓▓▓█▒█▓▓▓▓█▓█▓▓▓▓▓▓▓██▓▓▒▒█▓▓▓██▓▓██░▒▒█▓█▓▓▓▒▒▓▓▓██ ░▓▓▓██▓▓▒▓▓███▓█▓▓█▓▒▒▒▒▒▒▓▓██▓▓█
▒▒▓▓█▓▓███▓█▒█▓▓█▒ █▓▓▒▓█▓▒█▓▓███▓███▒▒ ▒▒▓▓█████▓█▒█▓███▓▒▒▒▒▒▓▓▓█░▓▓███▓▓▓▓███▓█▓██▓▓▓▒█▒▓▓▓█▓█▓▓█
▒▒▓█▓▓▓▓▓▓█▒▒▒█████▓▓▒ ▓█▓▒▒██ ░▒███▓▓▒▒▓██▓████▓▓▓█▓▓▓█▓▓▓▒░▒▒▒▓▓▓█▓███▓██▓███▓▓▓▒▒▒██▓█▓█▓▓█▓▓▓▒▓▓
▒▓▓█▓▒▒▒▓▓▓█▒ ░▒█▓█▓█▓▒▓▓█░▒█░░▓▓▓█ ███▒▓████▓███▓██▓▓█▓▓▒▒░ ░▒▒▒▓█░████▓▓░█▓████▓▓▒░░ █▓▓▓██▓▓▒▒ ▒▓
▓██▓▓▒ ▒▒▓█▓▒░▒█▓▓▓██▓▓▓█░ █▓█▒▒███▒█▓▓▓▓▓█ █▓▓▓█▒▓█▓▒▒██▓▓▒░▒▒▒▓█░ ░█▓▓▒░░▒▓▓█ ▒█▓▓▒▒░█▓▓▓██▓▓▓▒▓▒▓
▓███▓▒▒▒▓█▓▒▒▒▓█▓▓▒▓▓█▓████▓▓▓██▓▓▓████▓▓██▒█▓▒▒▒▒▒▓█▒░▒█▓▒▒▒▒▒▓▓▓█░░█▓▓▒▒ ▒▒▓▓█▒█▓▓▒▒█▓▓▒▓▓▓█▓▓▓▓▓▓
█████▒▒▓▓▓█▓▒▓▓▓█▓▒▒▓▓█▓█▓▓▓▒▓▓▒▒▓▓▓█░▒██▓▓█▓▓▓░ ░▓▓▓█ ▒█▓▓▓▓▒▓▓▓█▓██▓▒▒▒░░░▒▓▓▓██▓▓██▓▓▓▒▒▓▓▓█▓▓█▓▓
██▓██▓▒▓▓██▓▓█▓█▓█▒▒▒█▓▓▓█▓▓▒░░░▒▓██▒ ▒█▓▓▓▓█▓▒▒░▒▒▓█▒▒██▓▓▓█▓▓██▒▓█▓▓▓▒▒▒░▒▒▒▓▓▓███▓▓▓▓▒▒▓▒▒███████
▓▓▓▓█▓█▓████▓██▓▓▓░▒█▓█▓▓▓█▒▒░ ░▒▓▓▓█░▒██▓▓█▓▓▓▒▓▒▒▓█▓█▓▓█▓█▓▓█ ░░▒▒██▓▓█▒▒▓▒▓▓▓█▓█▓▓▓▒▒▒░░░▓█▓█▓█▒▒
▓▒▓▓▓█ ███▓▓█▓█▓▒▒░░█▓▓ ▓▓▓█▒▒░▒▒▒▓▓▓██▓▓▒▒▒█▓▓▒▓▒▓▓█▓█▓▒▒█▒██▒░▒▒▒█▒ ██▓█▓█▓▓▓█▒▒▓█▓▒▒▒░░ ░█▓▓▓▓▓█░
▓▒▒▒▓█▒▒█▓▓▓▓▓▓█▒░ ░█▓█▓▓██▓▓█▓▓▒▓▓██▓▓▓▒▒▒░▒█▓▓▓█▓▓██▓▓▓▒ ▒▓██▒▒▒█▓█░▒█▓████▓█▒░▒█▓▓▓█▒▒░▒░▒█▓▓▓▓█ 
▒▒▒▒█▓██▓▓▓▒▒██▓▒▒░░▒███▓█▒█▓█▓▓▓▓██▓▓▓▒▒░░ ░░█▓██▓█▓▓█▓█▒▒▒▓▓▓█▒█▓▓▓██▓▓▓█▓██▒░ ░▒█▓█▓▓▓▒▒▒█▓▒▒▒▓▓█
▒░░░▒▓▓█▓▓▒▒▒▓█▓▒▒▒▒▒▓███░▒▒█▓█▓▓█▓███▓▒▒▒░░░▒██▒▒█▒▒▓▓█▓▒▒▒▓▓█▓▓▓█▓▒█▓▓▒▓▒▓▓██▒░▒█████▓▓▓▒▓█▓▒▒▒▓▓█
▒░ ░▒▒▓▓█▓▒ ▒▓▓█▓▒▓▒▓▓▓█░ ░▒▒▓▓█▓█▓██▓▓▓▓▒▓▓▒▒▓▓█░ ░▒▓▓█▓▓▒▓███▓▓█▓▒ █▓▓▒▒▒▒▓▓▓█▒█▓█▓██▓█▓▓█▓▓▒ ▒▒▒█
▒░░░▒▒▓▓▓█▒█▒▓▓▓██▓█▓██████▒█████▒▓▓▓██▓▓▓▓▓▒▒▓▓▓█▒▒█▓█░█▓▓▓▓████▓▓▓▒█▓▓▒░▒▒▒▓▓▓█▓▓▒▓███ █▓█▓▓▒▒▒▓▓▓
▒▒▒▒▒█▓▓███▓█▓▓████▒█▓▓█▓▓▓█▓▓▓█▒▒▒▓█▓████▓▓▒▓▓▓█▓██▓█░ ░█▓▓███▒ ██▓▓█▓▓░░░▒▓▓████▒ ▒▓▓█▒█▓██▓▓▒▒▓▓█
▒▓▒▒▓▓▓█▓▓█▓▓███▓█▓▒▒▓█▓▓▓▓▓█▓█▓▒ ▒██▓█▓▓▓█▓▓▓██▓▓▓█▓▓██▒█▓███▓███▓██▓▓▓░ ░▓█▓██▓▓▓▓▓██▒▒████▓▓▒▓██▓
█▓█▓▓▓█▓▒▒▓▓████▓▓▒▒▒█▓▓▓▒ ▒▒▒▓█▓▒█▓▓ ▓█▓▓▓██▓██▓▓▓▒▓▓█▓██████▓█▓▓▓▓██▓▒▒░░▓▓█▓▓█▓▓▓█▒ ██▓▓▓███▓▓▓█▓
▒██▓██▓▒▒▒▒▒▓▓▓█▓▒▒░█▓▓▓▒▒░▒▒▓▓█▓▓▓█▓▓█▓▒▓▓▓██▓▓▓▒▒▒██▓▓▓███▓▓▒▒▓▓▓▓█▓▓▒▒░▒▓█▓▓▓▒█▓████▓▓█▒▓▓█▓█▓█▓▒
▒▓██▓▓▒▒▒░▒▒▒▓▓▓█▓█ ░██▓▓▓▒▒█▓█▒█▓▓███▓▒▒▓██▓▓█▓▓▒ █▓█▒▒▒▒█▓▓▓▒░▒▒▒█▓█▓▓▒▓▒█▓█▓▒ ▒███▓▓▓▒▒▒▓▓█▓██ ▒▒
░█▓▓▓▒▒░░ ░▒▓▓▓███▓█▒▒▓██▓▒▓▓█░▒▒██▓▓▓▓▒▒▒█▓▓▒▓█▓▒█▓▓▓█ ▒▒▒█▓▒░ ░▒▒▓▓▓██▓▓▒▓▓▓█▓▒▓▓█▓▓▓▒▒░▒░▒▒▓▓▓█▓▒
 ░█▓▓▒▒▒░░▓▓█▓█▓██▓▓█▓▓█▓▓▓▓█▒ ░▒▒██▓▒▒▒ █▓▓▓▒█▓▓█▓▓▓▓▓██▒▓▓█▒▒░▒▒▒█▓██▓▓▓█▓███▓▒██▓▓▓▒▒░░ ░▓█▓██▓▓▓
░░▒██▓▓▓▒▒▓▓▓█▓▓█▓▓▓█▓▓███▓▓█▒░░██▓█▓▓▒▒▒██▒▒▒▒██▓▓▓▒▒▒▓▓███▓▓▒▓▒▒█▓█░ █▓██▓█▓ ██▓███▓▓▓▒░▒▒▓▓██▓██▓
▒▒▒█▓█▓▓▒▓█▓██▓▓▒▒▒▓▓██ ▒▒██▓█░█▓█▓▓█▓▓▒█▓▓▓▒░█▓█▓▓▒▒▒▒▒██▓█▓█▓▓▓█▓▓▓██▓█▓██▓▓▒█▓▓▓██▓▓▓▒▒▒▓▓█▒▒▓█▓█
▓▒█▓▓▓█▓▓▓██▓█▓▓▓▒▓██▓▒▒██▓█▓▓█▓▓▓▓▓▓█▓█▓█▓▒░ █▓▓▓▒▒░░▒▒▓▓▓▓██▓█▓██▓▓▓█▓▒▓██▓▓██▓▓▓▓▓█▓█▓▒▓▓█ ░▒█▓▓▓
██▓▓▓▓▓████▓▓▓█▒▒░█▓▓███▓▓▓█▓▓█▓▓▒▒▒▓▓██▓▓▒▒█▒▒█▒▒▒░ ░░▒▒▒██ █▓███▓▒▓▓██ █▓███▓░ ▒▒▓█ ██▓▓▓█▓███▓▓▓▒
█▓█▓▒▒▓▓▓█▓▓▓▒▒░░ ▒▒▓█▓█▓▓▒▓▒▓▓█▒ ░▓▓▓▓█▓▓██▓██▓▓▓▒▒░░▒▒▒▓▓█░▒██▓▓▓▒▒▓▓▓█▓▓█▓▓▓▒░▒▓▓█░▒█▓██▓▓█▓██▓▒▒
▓▓▓▓▒▒▓██▒█▓▓█▓█░░▒▒▒▓▓▓█▒▒▒▒▒█▓█░▒▒▒▓████▓▓▓█▓█▓▓▒▒▒▒▓▒▓▓█▒▒█▒ █▓▒ ▒▒▓█▓▓▓▓█▓▒▒▒▒▒▓█▒▒▒███▓▓▓▓█▓█░▒
▓▓▒▒░▒▒▓█▒ ██▓█▓████▓▓▓█▓▓▒ ▓▓█▓▓█▒▒▓▓▓██▓▓▓▓▓▓██▓▓▒▒▒█▓█▓█▓█▓███▓▓▒▒▓▓▓█▓▒▓█▓▓▓▓▒▓▓█▒▓██▓▓▓▒▓▒▓▓█░░
█▓▒▒░▒▓▓▓█▒▒█▓▓▓█▓▓▓████▓▓▓█▓█▓▓▓█▓▓▓███▓▓▓▒▒▒▓▓▓█▓▓▓█▓█▓████▓▓▓█▓▓▓▓▓▓█▓▒▒▓▓█▓█▓█▓█▓▓▓█▓▓▓▒▒▒▒▒▓█ ░
██░░ ▓▓▓█▒▒█▓▓▒█▓▓▓▓▓▓███▓███▓▓▒▓▓█▓▓█░ █▓▓▓▒░▒▒▓██▓█▓▓▓▓▓█▓█▓▒▓▓█▓▓█▓██▓▓ ▒▒▓████▓█▓█▓██▓▓▓▒ ▒▒▒▓█░
▓▓▓░░▒▒██▓▒▓█▒▒▒░░▒▒▓▓▓███▓█▓▓▓▒▓▓▓█████▓█▓▒░░░▓█▓███▓▓▒▓▓▓▓▓█▒▒▓█████▓█▓▓▓▒▓▓▓█▒▒███▓█▒░█▓▓█▒▒▒▓▓▓█
█▓▒▒▒▒▒▓▓███▓▒░░ ░░▒▒▓██▓▓▓█▓▓▒▒░▓▓█▓█▓▓▓▒▒░░ ░█▓▓▓▓▓█▓▒▒▒▒▓██▒ ██▓█▓▓▓▒█▓▓▓▓▓██ ▒▒█▓▓▓█░ █▓▒▒▒▓▓██▓
▓▓▓▒▓▒▓▓██▓▓▓▒▒░░░▓▒▓▓▓██▓ ██▒▒░ ▒▒▓▓▓███▓▒▒░░█▓▓▓ ▓▓▓█░ ▒▒▓▓▓██▓▓▒▓█▓▒▒ ██▓▓█▓▓███▓▓▓▓▓██▓▓█▓▓▓▓█▒▒
█▓▓▓▓█▓█▓▓█▓▓▓▓▒░▒▒▓▓▓█ ░██▓▓▓▒▒░▒▒▓▓█▓█▓█▓▒▒░▒█▓▓▓▓▓█▓▒░▒▒▒▓██▓▓▒▒█▓▓▓▓▒▓█▓█▒▒▓█▓█▓▒▒▓▓█░█▓██▓███░ 
▓██▓██▓█▓▓▓█▓██▓▒▒████▓██▓███▓▓▒▒▒▓▓█▓▓▒▓█▓▒▓▒▒▓█▓▓▓█▓▒▒▒▒▒▓▓▓█▓▒▒▒░██▓▓▓▓██▒▒▒██▓▓▒▒▒█▓█ ██░ █▓█▓█░
 ▒██▓▒██▓▒▒▒██▓▓▓▓▓█▒▒▓█▓▓▓██▓▓▓▒▒▓▓▓█▓ ▓█▓▓▓▓█▓▓█▓█▓▓▓▒▒▒▓▓▓█▓▓▒▒░ ░░██▓█▓▒▒░█▓▓▓░░░█▓███▓▒▒░▒▒▓▓▓█
▓█▓▓▒ ▒█▓▓░▒░▒█▓▓▓█▒▒░█▓▓▓▓█▓█▓▓▓▓▓▓██▓▒▓▓██▓████▒█░█▓▓▓▒▓▓▓███▓▓▓█░█▒████▓▓░░ ██▒▒ ▒▓▓▓█▓▓▓▒▒▓█▓██░
█▓█▓▓▓██▓▒░ ░░▒█▓█▒▒░ █▓▓▒▒▒▓▓█▓▓███░█▓▓▓█████▓▓█░░ ░██▓▓███▓▓██▓█▓█▓█▓█▒░█▓▒██▓▓▒░░▒▒▓▓▓█▓▓▓▒▓▓███ 
█▓▓█▓█▓▓▒▒░░░▒▒██▓▒▒▒█▓▓▒▒▒▒▒███▓█░░ █▓▓███▓█▓▓█▓█▒░░▒███▒▓▓▓▓▓██▓▓▓▓▓▓▓█ █▓█▓██▓▒▒░▒▓▓██▒█▓█▓▓███▓█
▓▓█▓█▓▓▓▒▒▒░▒▒█▓█▓█▒▓▓██▓▒░▒▒▓▓██▒▒█░░█▓█▓▓▓▒▒▒▓▓██░▒█▓▓▓▒▒▒▒▓█▓█▓▓▒▒▒▓▓▓█▒██▓█▓▓▓▒▓▓▓▓██░▒█▓▓█▓█▓▓▓
▓▒▓▓▓█▓▓▓▒▒▒▒█▓▓▓█▓█▓██▓▓▒░ ▒▓▓▓█▒█▓█████▓█▓▒░▒▒▒▓▓█████▓▒░▒▓█▒▓█▓▒▒▒▒▒██ ░█▓▓▒█▓▓▓█▓▓██▓░░▒█▓█▓▓█▒▓
▒▒▒▓▒▓██▓▓▒▓▒██▓▒▓▓▓███▓▒▒▒░▒▒▓████▓█▓███▓▓▒▒░░▒▒▒▓▓▓█▒▒█░ ░░▒▒███▒▒░▒█▓█░▒█▓▒▒▒█▓████▓▒▓ ░▒▓█▓▓▒▒ ▒
▒░▓▒▒▒▒▓█▓▓▓█▓▓▒▒▒▓▓██▓▓▓▒▓▒▒▓▓▓█▓▓▓▓▓▓█▓▓▓▒░ ░░▒▓▓██▒░█▓▓▒░▒▒█▓█▓█░ ░▓▓▓██▓▒▒░▒▒█▓███▓▒░░░▒▒█▓▓█▒▓▓
░░ ░░▒▒██▓▓█▓▓▒▒▒▒▓▓▓██▓█▓▓▒▓▓▓█▓▓▓▒▒▓█▓▓▓▒▒▒░▒▒▒▓▓▓█░░█▓▓▒▒▒█▓▓▒▓▓█░▒▒▓▓█▓▓▒░░░▒▒▓██▓▓▒▒▒▒▒▒▓██▓█▓▓
▒░░░▓▒█▓██▓██▓▒▒░▒▓▒▓▓██▓▓██▓▓█▓█▓▒▒▒▒▓█▓▓▓▒▒░▓▓▓▓██▒░ ▒█▓▓▓▒██▓▒▓▓█░▒▓▓██▓▒▒▒ ░░▒▓▓▓█▓▓▓▒█▓▓▓█▓▓▓██
▒▒▒▒▒█▓▓███▓▓▓▒░░░▒▒▓▓▓██▓██▓█▓▓▒▒▒ ▒▓▓▓██▓▓▒█▓▓▓██▓▒░░░█▓▓▓█▓█▒▒▒▓▓█▓▓▓█▓▓▓▒▓▓▒▒▒▓▓██▓█▓█▓█▓█▓▓▓▓▓█
▓▒▒██▓▓▓▓█▓▓▓▒▒▒ ░░▒▒▒█████▓█▓█▓▓▒▒▒▓▓▓████▓▓▓█▓██▓▓▓█░▒▒█▓█▓▓▓█ ▒▓▓▓█▓█▓█▓▓▓█▓▓▓▓███▓███▓▓▓██▓▓▒▒▓▓
▓▓█▓▓█▓▒▓▓█▓▓▓▒░░░▒▓▒▓▓▓██▓▓▓▓▓█▓▓▒▓▓▓█▓▓▓████ █▓▓█▓█▓█▓▒▓█▓█▓█▓█▓▓▓█▓██▒▒█▓█▒█▓██▓▓▓▓▓█▓▓▒█▓▓▓▒▒▒▒▒
██▓▓▓░▒▒▒▓▓██▓▒▒░▒▒▓▓▓▓█▓▓▓▓▒▒▒█▓▓▓▓▓██▓▓▓▓▓▓█░▒▓█▓█▓▓▓█▓█▓▓▓▒▒▓██▓█▓▒▓▓█ ▒█▒░ █▒▓█▓ ▓█▓▓▒▒▒██▓▓▓ ▒▒
▓█▓▓▒░░▒▒▓█▓▓▓▒▒▒▒▓█▓██▓▓▓▒▒▒▒▒▓███▓█ █▓▒▒▓▓▓█▒▒▒█▓▓█▓▓▓██▓▒▒▒▒▒▓▓█▓▒▒░▒▓██▓▒▒░▒▒█▓▓▓▓▓█▒░▒▒█▓▓▓▒▒▒▒
▓▓▒▒▒ ░▒▓▓███▓▓▓▒▓▓▓█▒▒█▓▓▓▒░░▒▒█▓▓█▓▓█▓▒▒▒▒▓▓█▒█▓▓▒▓▒▓█▓▓▓▓▒░▒▓▓██▓▒░ ▒▓▓▓██▒▒▓▒▓█▓▓▓█▒▒░░▒▒█▓▓▓▓▓▓
▓▓▒▒░░░▒▓▓███▓██▓▓██▒░░ █▓▒▒ ░░██▓▓▓██▓▓▒ ▒▒▓▓██▓▓▓▒▒▒▒█▓▓▓▓░░▒▓▓▓▓█▒▒░▓▓▓██▓█▓▓▓▓▓█▓█▒▒░ ░█▒▓█▓▓▓▓█
█▓▒▒▒▒▒▒▒▓▓███▓▒█▓█▓██▒▒█▓▒▒░░█▓▓▓▒█▓▓▓▒▒▒▒▓▓████▓▓█░ █▓▓▒▒░░ ░▒▒███▒▒▒▓███▓▓█▓▓█▓█▒██▓█▒░█▓████▓███
▓▓▓▓▓▓█▒▓▓███▓▒▒▒█▒▓█▓█▒█▓▒▒░█▓▓▓▒▒▒██▓█▒▒▓███▓████▓█░▒█▓▒▒▒▒░▒▒▓▓█▓▓▓▓███▓█▓▓████▒▒█▓▓▓▒█▓▓▓▓███▓▓▓
█▓█▓██▓▓▓███▓█▓█░ ▒██▓▓██▓▒▒▒▒█▓▒▒▒ ▒▒█▓▓▒▓▓█▓▓▓███▓█░██▓██▓▒▒▓▓▓█▒█▓▓█▒█▓▓▓▒▓██▓██ ▒█▓██▓▓▒▓█▓█▓▒▒░
██▓█▓█▓▓▓██▓▓▓▒▒▒▒█▓█▓▓█▓▓▓▒▓█▓▓▓▓▒▒▓▒▓██▓▓█ ▒▓▓██▓▓▓█▓███▓▓▓▒▓█▓█ ▒██░░▒█▓█▒▓▓▓▓▓▓█▒▓█▓▓▓▒▒▒▓▓▓█▒░░
█▓▓▓▒▒█▓█░▒█▓▓▓█▒█▓▓▓▒▓▓██▓▓▓▓██▓▓▒▒▒▓▓█▓▓█▒▒▓█▓█▓▓▒▓▓▓▓████▓▒▓██▓▒▓▓█ █▒██▓▒█▓▓▒▓▓▓██▓▓▒▒▓▒▒▓▓▓█▒░ 
███▒▒ ▒█░░░▒█▓█▓██▓▓▒▒▓▓▓▓█▓██▓▓█▓█▓▓▓▓██▓█▓▒█▓██▓▓▒▓▒▓▓███▓▓▓█▓█▓▓▓███▓█▓▓▒░▒▒▒▒▒▓█▓█▒▒▒░░░▒▓▒▓▓█░░
█▓▓▓▒▒▒▓█ ░░▒█▓▓█▓▓▒▒▒▒▒▓▓██▒▒▒▒▓██▓█▓█ ░██▓█▓▓█▓▓▒▒░▒▒██▓▓█▓█▓▓▓█▓███▓▓▓██▒░ ░░▒▒▒▓▓▓█▓░░ ░░▒▒▓▓▓█░
 ██▓▓▓▓▓▓█▒▒█▓█▓█▓▓▓▒░▒▒▒▓▓█▒░▒▓█▓████▓██▓▓█▓▓▓▒█▓▓▒ ▓▓▓█▒▒▓█▓▓▒▓█▓██▓█▓▓▓▓█░▒▒▓▒▒▓█▓█▒▒▒░░░▒▒▓▓███▒
░░▒██▓▓▓█▓▒█▓▓▓▒▓█▓▓▓ ▒▒▓█▓█░░░██▓▓█▓▓▒▓▓▓▓█▓▓▒▒▒█▓▒░▒██▒░▒▓██▒▒▒ ██▓▓▓▒▒█▓▓█▓▓█▒▓▓▓█▓▓▒▒▒▒▒▓▓▓█▓▓▓█
▒▒██▓█▓████▓▓▒▒▒▒▓█▓█░▒▓▓▓█▒░ █▓▓▓██▓▓▒▒▒▒▓█▒▒▒ ▒█▓▒█▒▓▓█░▒█▓▓▓▒▒▒▒▒█▓▒▒▒▓▓▓▓█▓▓▓▓██ █▓▓▓▒▒▒▒▓▓█ ██ 
▒█▓▓▓▓█▒█▓▓▓▒▒▒░▒█▓▓▓▒▒▒██▒▒░█▓▓▓▒▓▓█▒▒░░░█▓▓▒▒▒▒▒██▓▓▓█░ ░░██▓▓▒▒▒▓██▓░ ▒▒▓██▓███▒░░▒██▓▓▒▒█▓███▓█▒
▒▓█▓▒▒░▒▒█▓▓▒▒░░█▓▓▓▒▒▓▓▓▓█▒██▓▓▒▒▒█▓█▒▒ ░█▓▓▓▒▒▒▓▓██▓█▒░░░▒▒█▓█▓▓▓█▓▓▓▒░▒▒▒▓▓█▓▓▒▒▒░▒▓█▓▓▓▓▓████▓▓█
██▓▓▒░ ░█▓█▓▒▒▒ ░██▓▓▒▓▓▓███▓▓▓▒▒▒▒█▓██░░░▒█▓█▓▒▓▓████▓▒▒░▒▒▓▓█▓▓▓▓██▓▒▒▒▒▒▓▓████▓▒▓█▒▓██▓▓▓█▓█▓▓▓▓▓
▓██▓▒▒░▒█▓▓▒▒▒░░░▒▒█▓█▓▓█▒▓██▓▓▓▒ █▓▓▓▓█▒▒▒▒█▓▓▓█▓██▓█▓▓▒▒▒▒▓█▒███▓█▓▓▓▓▓▒▓▓▓██▓▓███▓█▓▓██▓█▒▓█▓▓▒▓▒
▓█▓▓▒▒▒▒▒█▓▓▒▒▒█▒▒▓███▓█ ▒▓▓██▓▒▒▒█▓▒▓▓▓█▒▒█▓██▓██▒█▓▓█▓▓▒▒▓█▒░░ ░█░█▓▓▓█▓▓██▒▓▓▓█▓▓ ▓█████▒▒█▓▓▒▒▒░
▒▒█▓▓▒▓▓▓▓█▓▓▓█▓█▓▓▓███▒▒▒▓███▓▓██▓▓▒▓██▓▒█▓▓▒▓█▓█▒▒▓▓█▓▓▒▓▓█▒▒░▒░█ ██▓█▓▓█▒▒▒▒▒█▓██▓▓███▓▓█░ ██▒▒░ 
█ ▒█▓▓▓▓█▓██▓█▓▓▓█▓██▓▓▓▒▒█▓▓███▓▓▒▒ ▓▓█▓▓█▓▓▒▓▒▓▓█░▒▓▓█▓▓▓▓█▒▒▒▒▒▓█▓▓█▓█▓█▒░ ░▒▒▒▓█▓██▓▓▓▓▓██▓▓▓▒▒▒
▓█▒█▓▓██▒█▓██▓█▓███▓▓█▓▓▓█▓▓▓█▓▓█▓▓▓▒▓▓▓██▓▓▒░░▒▒▓█ ▒▒▒▓██▓███▓▒▒▓▓██▓▒▒▓█▒▒▒░▒▒▒▓▓▓████▓▒▓▓▓██▓█▓▒▒
▓▓███▓█ ▒▒▓█▓▓▓▒▓▓▓█▓▒██▓██▓▒▒▓██▓▓▓▒▓▓█░ █▒▒░ ░▒▓▓█▓▒█▓█░███▓█▒▓▓█▓▒▒▒ ▒▒█▓▒▒▒▓█▓███▓█▓▓▒▒ ▒▒▓█▓▓▒▓
▓█▓▓██▒▒▒▒█▓▓▓▒▒▓▓▓▓█▒▒░███▓▒▒▒▓▓██▓▓▓▓███▓▒▒░░░▒▒██▓▓▓▓█░░█▓▓▓█▓█▓▓▓▒▒▒▒█▓▓▓▒▓▓▓▓█▒▓▓██▓▓▒▒▒█▓▓█▓▓▓
▒▒▓▓█▓▓█▓▓▓█▓▒▒▒▒▒▓▓█▓░ ░█▓█▒░░▓▒▓█▓▓███▓▓▓▒▒▒░▒▒▒▓▓█▓██░ █▓█▓█▓███▓▓▓▒▒▒▓█▓▓▒▓▓██░▒▒▓▓█▓▓█▓▓▓████▓█
▒▒▓▓█▓▓▓█▓█▓█▒▒░▒▓▓██▓▒░█▓▓▓█░ ░▒▒▓█▓█▓██▓█▓▒▒▒▒▒▓▓██▓█▒░█▓▓▓▒▓▓▓███▓█▓▒▓▓▓█▓█▓█░ ░▒█▓█▒████▓██▓███▒
 ▒▓▓▓█▓█▒█▓▓▓▒░░ ▒▓▓▓█▓█▓▓▓▓█░░░▒▒▒▓█▓▓▒░█▓▓▓▒▒▓▓▓▓███▓▒▓▓█▓▓▒▒▒▓▓███▓▓▓▓██▓███▒░░██▓█▒░▒▒███ ▓▓▓█▒▒
░▒▒█▓██ ░▒█▓▒▒▒▒░▒▒▓▓▓███▒▒█▓█░▒▒▒▓▓██▒▒ ░██▓▓▒▓▓▓█▓█▓▓▓██▓▒▒░▒▒▓▓▓███▓▓█▓▓▓▓█▓█▒█▓█▓▓█ ░█▓▓▓█▓▓█▒▒░
▒▒▒▓▓▓█░▒█▓▓▓▒▒▒░▒▒▒▓▓█▓▓▓ ▒▓▓██▒█▓█▓▓▒▒▒▒▒█▓▓▓▓██▓▓ █▓█▓▓▓▒▒ ░▒▒▓▓▓████▓▓▓▒▓▓▓██▓▓▓▓▓█░█▓▓▓▓█▓█▒▒░░
▒▒▓████░▒▒███▓▓▒▓▒▒▓▓█▓▓▓▒▒▒▒▓▓▓███▓█▓▓▓▓█▒▓█▓██ █▓▓▓▓████▓▓▒▒▒▓▓▓██▓▓█▓▓▓▒▒▓▓▓▓▓█▓▓▒▓▓█▓█▓▒▓▓█▒▒░░ 
▒▓▓▓█▓▓██▓▓▓██▓▓▓▓▓▓█▒█▓▓▒▒▓▓█▓██▓▓▓▓█▓▓▓█▓███▓█░░█▓▓██▓██▓█▒▒▒▓▓▓█▓▓▓▓█▓▒▒░▒▒▒▓█▓▒▓▒▒█▓▓▓▒ ▒▓█▓▒▒░▒
▓▓▓█▒▒▒█▓█▓█░▒██▓▓██░░░█▓▓▒▓███▓▓█▒▒▒▒█▓███▓▓█▓▓█▒▒█▓█▓▓▓▓█▓▓▒▓▓██▓▓▒▒▒█▒▒░ ▒▓▓▓▓█▒░░▒▒█▓▓▓▓▓▓▓█▓▒▓█
▓▓█ ░▒█▓▓██ ░▒▒███▓█░ ░█▓▓▓███▓▓▓▒▒▒░░░███▓▓▓▓▓▓▓█▓▓█▓▓▓▒▓█▓▓▓▓██▓▓▒▒ █▓▓▒▒▒▒▓███▒░ ░░▒▒█▓▓▓▓▓███▓▓▓
▓██░▒█▓▓▓▓▓████▓▓▓▓▓█░░▒███▓▓▓█▓▓▓▓░░ ░░█▓▓▓▒▒▒▓██▓███▒▒▒▓▓██▓█▓██▓▓▓▒▒█▓▒▒▒▓▓▓█▒▒▒▒▒▒▒▒████▓███▓█▓█
██▓█▒███ ▓▓█▓▓▓▓▓▒▓▓▓█▒██▓█▓▓▒▒█▓▓▓▒░░░▒▒█▓▓▒▒▓▓▓▓███▓░ ▒▓▓▓██▓▓▓██▓▓███▓▓▓▓▓██▓▓▒██▓▓▒▓▓▓█▒███▓▓▓██
█▓▓██▓█▓▓▓██▓▓▒▒▒▒▒████▓▓ ▓█▒▒▒▒█▓▓▒▒▒▒▒█▓█▓▓░▓▒▓▓▓█▓▓▓░▒▒███▓▓▓▓▓█▓█▓▓█▓██▓█▒█▓▓█▓▓███▓▓█ ▒▒█▓▓▓▓█▓
█▓▓▓▓▓▓█▓█▓▓▓▒▒▒░▒▓▓▓▓██▓▓▓█▒░ ███▓▓▓▒▒█▓▓▒▒░░ ▒▒▓▓▓█▓▒▒▒▓▓▓█▓▓▒▓▓██▓▓▓ ████ ░▒█▓█▓▓▓▓▓██▒▒▒▓█▓▓▒▒▒▓
█▓▒▒▒▓███▓██▓▓▒░ ▒▒▒▓▓▓██▓█▓█▒█▓█▓██▓▒▓██▓▓▒▒░░░▒▒▓▓██▓▒▓▓██▓▓▒▒▒▓█▓█▓▓▓▓▓███▒▒▒█▓▓▒▓▓▓▓██▓▓▓▓█▓▒ ▒▒
██▒ ▒██▓▓▒▓▓█▓▓▒░▒▓█▓██▓██▓▓▓█▓▓▓▓█▓█▓▓███▓▒▒▒▒▒▓██▓██▓▓▓███▓▒▒▒▒▓▓▓▓█▓▓▓█▓█▓████▓▓▒▒▒▓▓▓█▓▓▓███▓▓▒█
█▓▓▒▓▓█▓▒▒▒▓██▒▒▒▒▓▓█▓▓▓▓▓█▓█▓█▓▒▒▓▓▓██████▓▒▓▒▓▓▓███▓██▓██▓█▒▒░▒▒▒██▒███▒▓█▓▓▓▓█▒▒▒░▒▒▓▓▓█▓█▓▓▓█▓█▓
▓█▓▓██▓█▓▒░█▓▓▓▒▒█▓█▓▓▒▒▒█▒▒▓▓▓█▒▒▒▒▓█▓█▓█▓▓▓▓▓▓▓███▓▓█▓██▓▓▓▒▓░░▒▒▓█▒░ ░▒█▓▓▒▓▓██▒ ░░▒▒▒▓▓█▓▓▓▓██▓▓
 ▓██▓▓▓▓█░░░█▓█▓▓▓██▓▓▒▒▒░░▒▒▓█▒░ ░▒█▓▓█▓▓██▓█▓████▓█▓▒▓▓█▓▓▒▒░ ░░▓▓▓█▒░▒█▓▓▒▒▒▓█▓█░░▒▒▓▓███▓▓ ▓▓▓█▓
▓▓█▓▓▒▒█▓█ ░░██▓▓█▓▓▓▒▒░░ ░░▓▓█▒▒░▒█▓▓▓▒▓▓▓██▒█░░█▓▓▓▒ ▓▓▓█▓▓▒▒░▓▒▒▓▓▓███▓█▒▒▒▒█▓▓▓█▒▒▓▓▓███▓▓▓▓▓█▒▒
▓▓█▒▒▒▒▒▓▓███ ░█▓██▓▓▓▒▒░░░▓▓▓██▒▒▒█▓▓▒▒▒▓▓▓█▒░░ ░██▓▓▒▓▓██▓▓▓▒▒▒▓▓▓▓██▓▓▓▒▓▒░█▓▓▒▓▓█▒▓▓█▓▓▓███▓█░▒▒
▓█▓▒░░▒▒▒▒▓▓▓█▒▒█▓▓█▓▓▓▒▒░▒▒▒▓▓▓█▒█▓▓▓░▒▒▒▓▓█▒▒▒░▒▒█▓▓▓▓█▓▓█▓▓▒▒▓▓▓▓██▓▓▓▒▒░ ░░█▓▒▓▓▓███▒▒▓█▓▓▒█ ░░▒
█▓▓▓▒ ░░▒▒▓█████▓▓▒▓█▓█▓▓▒▒▓▓▓▓███▓▓▒▒ ░▒▒▓▓█▓▒▒▓▒▒▓██▓▓█ █░█▓█▓▓█▓█▒ █▓▓▓▒▒▒░█▓▒ ▒▓▓█░ ░▒█▓▓▓▒░░░▒▒
▓▓▓▒▒▒░▒▒▓▓▓██▓▓▒▒ ▒▓█▓▓▒▒▒▓▓████▓▓▓▒▒░▒▒▓▓█▓▓▓▒▓▓█▓██▓█▓▓█ █▓██▓██▓▓▒▓██▓▓▓▒█▓▓▓▒▓▓█▒░░░█▓▓▓▒▒▒░▒▒▒
